3,3,3,3,3,3,3,2,2,2,2,2,2,2,2,2,2,2,2,2,2,2,2,2,2,2,2,2,2,2,2,2,2,2,2,2
3,0,0,0,0,0,0,0,0,7,1,1,0,6,0,0,0,0,0,8,0,0,0,0,0,0,6,0,0,0,0,2,0,0,0,2
3,3,0,0,0,0,0,0,0,3,3,3,0,20,0,0,0,0,0,2,2,0,2,2,0,0,20,0,0,0,0,2,0,0,0,2
3,3,0,0,0,0,0,0,0,3,3,3,0,0,0,0,0,0,0,2,2,2,2,2,0,0,0,0,0,0,0,2,0,0,0,2
3,0,0,3,3,3,3,0,0,3,3,3,0,0,0,0,0,0,0,0,2,2,2,0,0,0,0,0,0,0,0,2,0,0,2,2
3,0,0,3,3,3,3,0,0,0,0,0,0,0,0,0,0,0,0,0,0,2,0,0,0,0,0,0,0,0,0,0,0,2,2,2
3,0,0,0,3,3,3,0,0,0,0,0,0,0,0,0,0,0,0,0,0,0,0,0,0,0,0,0,0,0,0,0,2,2,2,2
3,3,0,0,0,0,0,0,3,3,0,0,0,0,0,0,0,0,0,0,0,0,0,0,0,0,0,0,0,0,0,2,2,1,1,1
3,3,3,0,0,0,0,3,3,3,0,0,3,2,3,0,0,0,0,0,0,0,0,0,0,0,0,0,0,0,2,2,1,1,1,1
3,2,0,0,3,3,0,3,3,3,0,0,3,2,3,0,0,0,0,0,0,0,0,0,0,0,0,0,0,2,2,2,1,1,1,1
3,0,0,3,3,3,0,0,0,0,0,0,0,2,3,0,0,0,0,0,0,0,0,0,0,0,0,0,2,2,1,1,1,1,1,1
3,0,3,3,3,3,3,2,2,3,8,0,0,0,0,0,0,0,3,3,2,0,0,0,0,0,2,2,2,1,1,1,1,1,1,1
3,7,3,3,2,2,3,3,3,3,3,0,0,0,0,8,3,2,3,7,0,0,0,0,0,0,2,2,1,1,1,1,1,1,1,1
3,3,3,3,3,2,3,2,3,3,3,3,0,0,0,3,3,3,3,3,0,0,0,0,0,0,2,2,1,1,1,1,1,1,1,1
3,3,3,3,3,3,3,3,3,3,3,3,4,0,0,3,3,3,3,3,0,0,0,0,0,0,2,1,1,1,1,1,1,1,1,1
3,3,0,0,0,0,2,0,0,0,0,0,3,3,0,0,0,0,3,3,0,0,0,0,0,2,2,2,1,1,1,1,1,1,1,1
3,3,0,0,2,0,2,0,2,0,3,3,3,3,0,0,0,0,3,3,0,0,0,0,0,6,2,2,2,1,1,1,1,1,1,1
3,1,7,0,2,0,0,0,2,0,2,0,0,0,0,0,3,0,0,0,0,0,0,0,0,20,0,2,2,2,1,1,1,1,1,1
3,1,1,1,3,1,1,3,3,0,0,0,0,0,0,3,0,3,0,0,0,0,0,0,0,0,0,0,2,2,1,1,1,1,1,1
3,3,3,3,3,3,3,3,3,3,3,3,3,3,3,3,0,3,3,3,0,0,0,0,0,0,4,0,0,2,2,2,1,1,1,1
2,2,2,2,2,2,2,2,2,2,2,2,2,2,0,0,0,0,2,2,2,2,2,2,2,2,2,2,2,2,2,2,2,1,1,1
